
111111111111111111111
100001111111000000111
111100001110011110001
100110000010000000101
10P0CCCCCCCC1E101001
111111111111111111111