111111111111111111111
10C00011111100P000001
111100001110011110001
1C0110000010000000001
10000000C0001E100C001
111111111111111111111