111111111111111111111
10P001111111000000111
111100001110011110001
100110000010000000001
10000000C0000101E1CC1
111111111111111111111