111111111111111111111
1000011111110000P0011
111100001110011110001
100110000010000000001
10000000C0001E1000001
111111111111111111111